####################
#PDDDDDDDDRRGGGGDDD#
#DDRRRRRRDDDDDDDGGD#
#DDDDDDDDGGGGDRRBBD#
#DRRGGDDDRRRRDDDDBD#
#DDDDDDDDDRRGGDDDBD#
#DDRRBBBBBBBBBGGDBD#
#DDDDDBRRRRRDBBBBBD#
#DRRRDBDDDDDRRGGDBD#
#DBBBBDDDGGGGDDDBBD#
#DDDRRRRRRRDDDDRBDD#
#DGGRRRDDDDDDRRRBDD#
#DDDDDDDDDDDDDDDBBE#
#DRGGGGDDDDRRRBBBBR#
####################
