####################
#PDDDRRRGGGDDDDDDDD#
#DDDDRDDDDDRRRDDGGD#
#DDGGGDDDGGDDDDRRDD#
#DRRRDDDDDDRRRBBBDD#
#DDDDGGGGDRRBBBDBDD#
#DDRRRBBBBBBBRRRBBB#
#DDDDDBDRRGGGDDDDDB#
#DRRGGDBBBBDDRRRDDB#
#DDDBBBBDDBGGGRRDDB#
#DDDRRRRRRBDDDDBDDB#
#DDGGGBDDDBRRGGGRDB#
#DDDDDBBBBBBBBBDDDE#
#DRGGGGDDDDRRRBBBBB#
####################
