####################
#PDDDDDDDDDRDDDBBBB#
#DDDDDDRRRRRDDDBDDD#
#DDDDDDGGGGDDDDBDDD#
#DDDDDDGGGGRDDDBDDD#
#RRRRRDDRRRRDBBBDDD#
#DDDDDDDBBBBBBDDDDD#
#DDDDDDDBRRRRRDDDDD#
#DDDDDDDBDDDGGGGDDD#
#DDDDDDDBDDDDDDDDBD#
#BBBBBBBBBBBBBRDDBD#
#DDDDDDDDRRRRBRDDBB#
#DDGGGGDDDDDRBRRRDB#
#DDDDDDDDDDDRBBBBBE#
####################