####################
#PDDDDRRDDDDRRRRDDD#
#DDRRRDDDDDDDDGGGDD#
#DDGGGGRRRDDDDRRDDD#
#DDDDDDDRDDDRDDDDDD#
#RRRRRDDDGGGGDDRDDD#
#DDDDDDDBBBBRRDDDDD#
#DDRRRRDBDDDGGGDDDD#
#DDDDDDDBRRDDDGGGDD#
#BBBBBBBBBBBBBBBBDD#
#DRRRRRRRRRGGDDDBDD#
#DRGGGGDDDDRRRBBBDD#
#DDDDDDDDDDDDDDDBBE#
#DRGGGGDDDDRRRBBBBB#
####################
